abarque: abarca,abarques
aboque: aboca,aboques
aborde: abord,abordes
aborígen: aborigen,aborígens
abraçador: abraçadores,abraçadora
abrig: abrics,abriga
absente: absents,absenta
absoluto: absoluta,absolutos
abstractos: abstracte,abstracta
abstracts: abstracte,abstracta
absurd: absurdes,absurds
abundante: abundant,abundantes
acabar: acabades,acabat
acabo: acabades,acabat
acadèmique: acadèmic,acadèmiques
acave: acava,acaves
acceptar: accepta,acceptara
acompanyare: acompanyar,acompanyara
acordare: acordar,acordara
acorde: acord,acordes
acto: act,actos
actuada: actuo,actuat
actuades: actuo,actuat
actualitze: actualitza,actualitzes
actuats: actuo,actuat
acute: acut,acuta
addictive: addictiu,addictives
additive: additiva,additives
ade: ada,ades
adjective: adjectiu,adjectives
adjunte: adjunt,adjunta
adjunto: adjunt,adjuntos
admete: admet,admeta
administrative: administrativa,administratives
admir: admires,admirs
admirador: admiradores,admiradora
adobe: adob,adoba
adolescente: adolescents,adolescentes
adquirire: adquirir,adquirira
adresse: adressa,adresses
adulte: adult,adulta
adulto: adult,adultos
advocate: advocada,advocata
afalague: afalaga,afalagues
afecto: afectes,afectos
agafe: agafar,agafa
agafes: agafar,agafa
agradada: agrada,agradat
agradar: agrada,agradat
agradats: agrada,agradat
agressive: agressiva,agressives
aguante: aguant,aguanta
aixe: aix,aixes
ajorn: ajornes,ajorna
ajud: ajudo,ajuda,ajuds
ajuds: ajudo,ajuda
ajunt: ajuntes,ajunta
ajusto: ajusta,ajustos
alarmante: alarmants,alarmantes
albanés: albanès,albanesa
alert: alertes,alerta
alet: aletes,aleta
alié: aliè,aliens
allarg: allargues,allarga
alle: all,alla
almirante: almirant,almirantes
altare: altar,altares
alter: altera,alters
alternatiu: alternatives,alternatius
alum: alumes,alums
am: ames,ams
amac: amagues,amaques
amag: amagues,amaga
amante: amants,amanta
amare: amar,amara
ambiente: ambients,ambienta
amés: amès,amesos
amig: amic,amiga
amiguete: amiguets,amigueta
amore: amor,amora
an: ana,ans
analfabeto: analfabet,analfabetos
analític: analítiques,analítica
analitze: analitza,analitzes
anate: anat,anata
anave: anau,anaves
anc: anques,anca
ande: anda,andes
anim: animes,anims
animare: animar,animara
annexe: annexa,annexes
anomen: anomenes,anomens
antar: antares,antara
ante: ants,antes
antecedente: antecedent,antecedentes
antig: antigues,antiga
antique: antigues,antiques
antó: antò,antona
anunciante: anunciant,anunciantes
anunciare: anunciar,anunciara
anuncie: anuncia,anuncies
apag: apagues,apaga
aparegue: aparega,aparegues
aparelle: aparells,aparella
aparque: aparca,aparques
ape: ap,apa
aplic: apliques,aplica
aprecie: aprecia,aprecies
aprovada: aprova,aprovat
aprovades: aprova,aprovat
aprovats: aprova,aprovat
aprove: aprova,aproves
apto: aptes,aptos
aqueste: aquest,aquesta
aquesto: aquest,aquestos
arà: aran,arana
argumento: argument,argumentos
ariete: ariet,arietes
arm: arma,arms
armamento: armament,armamentos
aromàtic: aromàtiques,aromàtica
arque: arcs,arques
arquitecto: arquitectes,arquitectos
arranque: arranca,arranques
arrele: arrels,arrela
arrenque: arrenca,arrenques
arreplegue: arreplega,arreplegues
arreste: arrest,arresta
arribave: arribava,arribaves
arribe: arrib,arriba
arrisque: arrisca,arrisques
arrive: arriva,arrives
arrós: arròs,arrosa
arrossegue: arrossega,arrossegues
ars: are,ara
asalte: asalt,asalta
asalto: asalt,asaltos
asfixiante: asfixiant,asfixiantes
aspect: aspectes,aspects
aspecto: aspectes,aspectos
aspirante: aspirant,aspirantes
assaig: assajos,assaigs
assegurador: asseguradores,asseguradora
assessore: assessors,assessora
astut: astuta,astuts
atabal: atabales,atabala
atanse: atansa,atanses
atente: atent,atenta
atorgue: atorga,atorgues
atreve: atreu,atreves
augusto: augusta,augustos
aumento: aument,aumentos
aur: aura,aurs
auta: auto,autos
autes: auto,autos
autore: autor,autora
avale: aval,avala
avanço: avanç,avanços
aventatja: aventatge,aventatges
àvide: àvid,àvides
avie: avia,avies
avís: avise,avises
avisa: avise,avises
axiom: axiomes,axioma
bag: bac,baga
bages: bajo,bajos
bags: bac,baga
baig: bajo,bajos,baja
baile: bail,baila
baja: bajo,bajos
ballad: ballat,ballada,ballads
ballads: ballat,ballada
balle: ball,balles
banque: banca,banques
banquete: banquets,banqueta
bany: banya,banys
barallare: barallar,barallara
barbar: barbara,barbars
barc: barques,barca
bare: bars,bara
barreig: barreges,barreja
barrete: barrets,barreta
batall: batalles,batalla
bate: bades,bata
bave: bau,baves
beato: beats,beatos
bec: beques,beca
beg: beques,bega
begue: beques,begues
beguí: beguin,beguina
bele: bel,bela
bell: belles,bells
benjamí: benjamin,benjamina
bí: bin,bins
big: bigues,biga
bigote: bigot,bigotes
billete: billet,billetes
bite: bits,bites
blonde: blonda,blondes
bloque: bloc,bloques
boix: boixos,boixa
bojo: boges,bojos
boleto: bolet,boletos
boníssim: boníssimes,boníssima
bor: bora,bors
borne: born,bornes
borse: borsa,borses
bote: bot,bota
brac: bragues,braca
braço: braç,braços
branc: branques,branca
brec: brega,breca
breve: breus,breves
brigade: brigada,brigades
brillante: brillants,brillantes
britànic: britàniques,britànics
brog: broc,broga
brote: brots,brota
brune: brun,bruna
brute: bruts,brutes
bruto: bruts,brutos
bufe: buf,bufa
buid: buides,buids
bulle: bulls,bulla
buste: bust,busta
busto: bust,bustos
caballe: caballs,caballa
cabrejo: cabreig,cabrejos
cac: caga,caca
cacahuete: cacahuet,cacahuetes
cad: cat,cada,cads
cadete: cadets,cadetes
cads: cat,cada
cagó: cagon,cagons
cagona: cagon,cagons
cague: caga,cagues
caiente: caient,caientes
caig: caic,caiga
caigue: caic,caigues
caimà: caiman,caimans
caixet: caixetes,caixeta
caja: caic,caiga
calaixo: calaix,calaixos
calder: calderes,caldera
cambie: cambia,cambies
campist: campistes,campista
cancerigen: cancerígens,cancerigens
candente: candent,candentes
candidate: candidat,candidata
candidato: candidat,candidatos
canelle: canell,canella
canonad: canonades,canonada
canònic: canòniques,canònica
cansare: cansar,cansara
cantante: cantants,cantanta
cantate: cantada,cantata
canviare: canviar,canviara
canvie: canvia,canvies
cany: canyes,canya
capaça: capaç,capaces
capfic: capfiques,capfica
capgrós: capgròs,capgrosos
capitale: capitals,capitales
característic: característiques,característica
carne: carns,carna
càrrecs: càrreg,càrregues
carregue: carrec,carregues
carrete: carret,carreta
cartutxo: cartutx,cartutxos
casco: cascs,cascos
caset: caseta,casets
casí: casin,casins
casina: casin,casins
casque: casca,casques
casse: cassa,casses
cassete: casset,casseta
castelle: castells,castella
cate: cat,cata
categorie: categoria,categories
catxe: catxa,catxes
causante: causant,causantes
caute: cauts,cauta
cave: caus,caves
cele: cels,cela
cell: cella,cells
cente: cents,centa
centrale: centrals,centrala
certe: certs,certa
certifique: certifica,certifiques
científic: científiques,científica
cime: cim,cima
cinquanté: cinquantè,cinquantena
cinqué: cinquè,cinquena
cint: cintes,cinta
cistell: cistelles,cistells
cit: cid,cides
clinic: cliniques,clinica
clínic: clíniques,clínics
cló: clon,clons
çó: çò,çons
cobarde: cobard,cobardes
coc: coques,coca
coda: code,codes
cog: coques,coga
cognitiu: cognitives,cognitiva
coherente: coherent,coherentes
coincidente: coincident,coincidentes
coixo: coix,coixos
colegue: colega,colegues
colgue: colga,colgues
coll: colles,colls
colleja: college,colleges
collite: collides,collita
cols: cole,cola
comandante: comandants,comandanta
comande: comanda,comandes
comarque: comarca,comarques
combaté: combaten,combatens
començada: començar,començat
començades: començar,començat
començats: començar,començat
començau: començaves,començava
comentare: comentar,comentara
comento: comenta,comentos
comete: comet,cometes
comique: comics,comiques
còmode: còmoda,còmodes
compactos: compacte,compacta
compacts: compacte,compacta
comparative: comparatius,comparatives
compense: compensa,compenses
competente: competent,competentes
competitive: competitiva,competitives
complemento: complements,complementos
complet: completes,complets
complexo: complex,complexos
componente: component,componentes
composte: compostos,composta
compre: compro,compra
comprenda: comprende,comprendes
compres: compro,compra
compromés: compromès,compromesa
compromete: compromet,comprometa
compulsive: compulsiva,compulsives
computador: computadores,computadora
comunale: comunals,comunales
comunicare: comunicar,comunicara
comunique: comunica,comuniques
concepto: conceptes,conceptos
concert: concerta,concerts
concrete: concrets,concreta
concreto: concrets,concretos
concursante: concursants,concursanta
concurso: concurs,concursos
conectare: conectar,conectara
confirm: confirma,confirms
conflict: conflicte,conflictes,conflicts
conflictive: conflictiu,conflictives
conflicto: conflicte,conflictes,conflictos
conflictos: conflicte,conflictes
conflicts: conflicte,conflictes
conforte: confort,conforta
confront: confrontes,confronta
congue: conga,congues
conjunto: conjunts,conjuntos
conque: conca,conques
consciencie: consciencia,consciencies
consciente: conscients,conscientes
consecutiu: consecutives,consecutius
consentire: consentir,consentira
consider: considere,consideres,considers
considers: considere,consideres
consistente: consistent,consistentes
consorte: consort,consortes
constante: constant,constanta
constat: constata,constats
construeixe: construeix,construeixes
consume: consum,consuma
contact: contacta,contacts
contaminante: contaminants,contaminantes
contemplave: contemplava,contemplaves
contente: content,contenta
contexte: context,contextes
contexto: context,contextos
continente: continents,continentes
contingente: contingent,contingentes
continuos: continuat,continuo
contracte: contract,contracta
contrapés: contrapès,contrapesos
contraste: contrastos,contrasta
contrataque: contrataca,contrataques
contrate: contrades,contrata
contrato: contrades,contratos
controle: controls,controles
contundente: contundent,contundentes
conveniente: convenient,convenientes
convers: converses,conversa
convincente: convincent,convincentes
convocante: convocant,convocantes
convoque: convoca,convoques
cooperative: cooperatiu,cooperatives
cope: cop,copa
copete: copets,copeta
corda: corde,cordes
cordiale: cordial,cordiales
cords: corde,cordes
corne: corn,corna
corque: corca,corques
correcto: correctes,correctos
corrupto: corrupta,corruptos
corsa: cora,cors
corses: cora,cors
corsos: cora,cors
costume: costums,costuma
cote: cots,cota
coto: cots,cotos
coupe: coup,coupes
create: creada,creata
crei: creies,creia
creié: creien,creiens
creix: creixes,creixa
creixé: creixen,creixens
cremave: cremava,cremaves
creme: crem,cremes
crepe: creps,crepes
crid: crit,crides,crids
crids: crit,crides
crie: cria,cries
crite: crit,crita
critique: critica,critiques
croate: croat,croata
crònic: cròniques,crònics
croquet: croquetes,croqueta
cuanto: cuant,cuantos
cuart: cuartos,cuarta
cube: cub,cuba
cuirosos: cuiro,cuiros
cultive: cultiu,cultives
culto: cult,cultos
culturale: culturals,culturala
cur: cures,curs
curse: cursos,curses
dà: dan,dana
dall: dalla,dalls
danys: danye,danya
darrer: darreres,darrers
davalle: davall,davalla
dé: den,dens
debate: debats,debata
decente: decents,decenta
decisive: decisiva,decisives
declarante: declarant,declarantes
dedicare: dedicar,dedicara
dedicate: dedicat,dedicata
dedique: dedica,dediques
defensada: defensa,defensat
defensades: defensa,defensat
defensats: defensa,defensat
defensore: defensor,defensora
defensos: defensa,defenso
deficiente: deficients,deficientes
definitive: definitiu,definitives
degrade: degrada,degrades
deie: dei,deies
deixar: deix,deixa
deixo: deix,deixa
delat: delata,delats
delegue: delega,delegues
delito: delit,delitos
demanave: demanava,demanaves
demandante: demandant,demandantes
demòcrat: demòcrates,demòcrata
denegue: denega,denegues
dense: densa,denses
dente: dent,dentes
dentist: dentistes,dentista
denunciante: denunciant,denunciantes
denunciare: denunciar,denunciara
depende: depend,dependes
depés: depès,depeses
depressive: depressiva,depressives
dere: der,dera
derive: deriva,derives
derrer: derrera,derrers
desafiante: desafiant,desafiantes
desapareix: desapareixes,desapareixa
desate: desades,desata
descalço: descalç,descalços
desconcert: desconcerta,desconcerts
desconcertante: desconcertant,desconcertantes
descontento: descontent,descontentos
descriptive: descriptiva,descriptives
descrito: descrit,descritos
desé: desè,desena
desenvolupa: desenvolupats,desenvolupat
desenvolupar: desenvolupats,desenvolupat
desenvolupara: desenvolupats,desenvolupat
desenvolupe: desenvolupats,desenvolupat,desenvolupa
desenvolupes: desenvolupats,desenvolupat,desenvolupa
desenvolupo: desenvolupats,desenvolupat
desèrtic: desèrtiques,desèrtica
desgaste: desgast,desgasta
desintegrador: desintegradores,desintegradora
desitja: desitge,desitges
desmaie: desmaia,desmaies
desmunt: desmunta,desmunts
desperte: desperts,despertes
desplegue: desplega,desplegues
destaque: destacat,destaca,destaques
destaques: destacat,destaca
destinate: destinat,destinata
destorbe: destorb,destorba
destructive: destructiu,destructives
desvie: desvia,desvies
detergente: detergents,detergentes
determinante: determinants,determinantes
deurie: deuria,deuries
devoto: devota,devotos
diabòlic: diabòliques,diabòlics
dialogante: dialogant,dialogantes
diamante: diamant,diamantes
dibuixe: dibuixa,dibuixes
dibuixo: dibuixa,dibuixos
diente: dient,dientes
diet: dietes,dieta
diferencie: diferencia,diferencies
dificult: dificulta,dificultos
dificultads: dificultats,dificultada
difunto: difunts,difuntos
dig: dics,diga
digitale: digitals,digitales
digue: dics,digues
diguer: digueres,diguera
diminutive: diminutiu,diminutives
diminuto: diminut,diminutos
diposite: diposit,diposita
dique: dics,diques
direct: directa,directs
directive: directiva,directives
directo: directa,directos
dirigente: dirigents,dirigentes
discrete: discrets,discreta
discreto: discrets,discretos
discurso: discurs,discursos
dispar: dispare,dispara,dispars
disparate: disparada,disparates
dispars: dispare,dispara
disperse: dispers,disperses
disperso: dispers,dispersos
distante: distants,distantes
distint: distintes,distints
distinto: distintes,distintos
dius: dir,diu
diva: dir,diu
dive: dir,diu,dives
dives: dir,diu
dixe: dixa,dixes
dixo: dixa,dixos
documento: document,documentos
dolça: dolce,dolces
dolente: dolent,dolenta
domestique: domestica,domestiques
donau: donaves,donava
donzell: donzelles,donzella
dormire: dormir,dormira
dorso: dors,dorsos
dote: dot,dota
dotzé: dotzè,dotzenes
droit: droide,droides
droits: droide,droides
druid: druides,druida
duele: duel,duela
dug: duc,duga
dugs: duc,duga
dugue: duc,dugues
eclipse: eclipsa,eclipses
economist: economistes,economista
edictos: edicte,edictes
editare: editar,editara
editor: editora,editors
educació: educaciò,educacions
eixe: eixos,eixes
eixugue: eixuga,eixugues
elè: elen,elena
electo: electe,electes,electos
electos: electe,electes
electrónic: electróniques,electrónica
elefante: elefant,elefanta
elegante: elegants,eleganta
eleve: eleva,eleves
elite: elits,elites
elle: ell,ella
embolcalle: embolcalls,embolcalla
emés: emès,emesos
emocionante: emocionants,emocionantes
empasse: empassa,empasses
empate: empat,empata
emperó: emperò,emperons
empés: empès,empesos
encaix: encaixes,encaixa
encantador: encantadores,encantadors
encante: encants,encantes
encanto: encants,encantos
encare: encar,encara
encarrecs: encarreg,encarregues
endinse: endinsa,endinses
endugue: enduc,endugues
ene: en,ena
enfad: enfades,enfada
enfonse: enfonsa,enfonses
enganye: enganys,enganyes
engegue: engega,engegues
enrecord: enrecordes,enrecorda
enredosos: enredo,enredos
ent: entes,ents
enté: enten,entens
entenie: entenia,entenies
entrebanque: entrebancs,entrebanques
entreg: entregues,entrega
entremés: entremès,entremesos
entrevist: entrevistes,entrevists
envolt: envolta,envolts
enyor: enyores,enyors
époque: época,époques
equitative: equitatiu,equitatives
equivoca: equivoque,equivoques
ere: sers,era,eres
eres: sers,era
ergonòmic: ergonòmiques,ergonòmica
errante: errant,errantes
ers: sers,era
escabetxo: escabetx,escabetxos
escanejo: escaneja,escanejos
escènique: escènic,escèniques
escolto: escolte,escolta
escote: escot,escota
escrigue: escric,escrigues
escrito: escrits,escritos
escultur: escultures,escultura
ése: ésa,éses
esfèric: esfèriques,esfèrica
esglaie: esglai,esglaies
espant: espantes,espants
especifique: especifica,especifiques
esperada: espera,esperat
esperades: espera,esperat
esperar: espera,espero
esperats: espera,esperat
esperau: esperaves,esperava
espesse: espessa,espesses
espós: espòs,esposes
esque: esca,esques
esqueleto: esquelets,esqueletos
esquive: esquiva,esquives
éssera: sers,ésser
ésseres: sers,ésser
éssers: sers,ésser
estalvie: estalvia,estalvies
estans: estara,està
estar: estara,està
estau: estara,estava
estave: estara,estava,estaves
estaves: estara,estava
este: estos,esta
estema: estara,estem
estenall: estenalles,estenalla
estiguis: estara,estigui
estime: estim,estima
estirpe: estirp,estirpes
estrambòtic: estrambòtiques,estrambòtica
estranger: estrangeres,estrangers
estranye: estrany,estranya
estrel: estreles,estrela
estudiada: estudio,estudiat
estudiades: estudio,estudiat
estudiats: estudio,estudiat
estudie: estudio,estudia,estudies
estudies: estudio,estudia
estupend: estupendes,estupenda
ete: et,eta
evidente: evidents,evidentes
evitada: evita,evitat
evitades: evita,evitat
evitar: evita,evito
evitats: evita,evitat
evolutive: evolutiu,evolutives
evoque: evoca,evoques
exacto: exactes,exactos
excedente: excedent,excedentes
excessive: excessiva,excessives
exclusive: exclusius,exclusives
executive: executius,executives
exhausto: exhausta,exhaustos
exigente: exigents,exigentes
existeixes: existir,existeix
existente: existents,existentes
expectative: expectativa,expectatives
expediente: expedients,expedienta
experimento: experiments,experimentos
experto: experta,expertos
explícito: explícites,explícitos
explics: explicar,explica
expliques: explicar,explica
explosive: explosiva,explosives
expresse: expressa,expresses
expressive: expressiva,expressives
externe: externs,externa
extés: extès,extesa
extracto: extracte,extractes,extractos
extractos: extracte,extractes
extranye: extranys,extranya
extreme: extrems,extrema
exultante: exultant,exultantes
fabricante: fabricant,fabricantes
faça: face,faces
facile: facil,faciles
facilite: facilitat,facilita
facilites: facilitat,facilita
facta: facto,factos
facts: facto,factos
faics: faig,faiga
fajo: faig,fajos
fale: fal,fala
fall: falles,falls
falt: faltes,falts
falto: faltes,faltos
fam: fama,fams
fantàstic: fantàstiques,fantàstics
farie: faria,faries
fatale: fatals,fatales
fatigue: fatiga,fatigues
fatxe: fatxa,fatxes
favore: favors,favores
favorite: favorits,favorita
favorito: favorits,favoritos
feie: fei,feies
feme: fem,femes
feridor: feridores,feridora
festejo: festeja,festejos
festive: festiu,festives
fí: fin,fina
figurante: figurant,figurantes
fil: files,fils
filantròpic: filantròpiques,filantròpica
fille: fill,filla
finale: final,finales
finde: find,findes
finest: finestes,finesta
finite: finit,finita
finito: finit,finitos
fique: figa,fiques
fir: fires,firs
firm: firmes,firms
firmante: firmant,firmantes
firmare: firmar,firmara
fis: fin,fina
físic: físiques,físics
fixe: fixos,fixes
flac: flaques,flaca
flagrante: flagrant,flagrantes
flame: flam,flama
flor: flora,flors
floret: floretes,floreta
flot: flotes,flots
flotante: flotant,flotantes
fluit: fluid,fluida
fluits: fluid,fluida
foguer: fogueres,foguera
folleto: follet,folletos
forja: forge,forges
form: formo,forma,forms
formale: formals,formala
formato: formada,formatos
forme: formo,forma
formes: formo,forma
forms: formo,forma
forte: fort,forta
fota: foto,fotos
fotes: foto,fotos
fotie: fotia,foties
fots: foto,fotos
fous: sers,fou
fracàs: fracasso,fracassos
fracasa: fracasso,fracassos
fracasos: fracasso,fracassos
frag: fracs,fraga
fragmento: fragments,fragmentos
freàtic: freàtiques,freàtica
frede: fred,fredes
fregue: frec,fregues
fresc: frescos,frescs
fresse: fressa,fresses
fronte: fronts,fronta
fronter: fronteres,frontera
frustrante: frustrant,frustrantes
fug: fugues,fuga
fuig: fuges,fuigs
fum: fumes,fums
fumadore: fumadors,fumadora
fumet: fumetes,fumeta
funesto: funesta,funestos
furte: furt,furta
fusos: fu,fus
futur: future,futura,futurs
futurs: future,futura
gada: gate,gates
gades: gate,gates
gaie: gais,gaies
galé: galen,galens
gal·le: gales,gal·les
galope: galop,galopa
ganyot: ganyotes,ganyota
garantie: garantia,garanties
garantire: garantir,garantira
gare: gar,gara
garraf: garrafes,garrafa
gast: gastes,gasts
gasto: gastes,gastos
gat: gate,gates,gada
gato: gate,gates,gatos
gatos: gate,gates
gats: gate,gates
gener: generes,geners
generale: generals,generala
generate: generada,generates
gentile: gentil,gentiles
geològic: geològiques,geològics
geomètric: geomètriques,geomètrica
gerente: gerent,gerenta
gesto: gestes,gestos
geto: get,getos
gí: gin,gina
gille: gill,gilles
git: gita,gides
give: giu,gives
globale: globals,globales
glorie: gloria,glories
gom: gomes,goma
gor: gore,gora,gors
gors: gore,gora
gorsa: gore,gora,gors
governe: governs,governa
grà: gran,grans
grana: gran,grans
granate: granada,granates
granes: gran,grans
gratificante: gratificant,gratificantes
grato: grata,gratos
greg: grecs,grega
greny: grenyes,grenya
greuja: greuge,greuges
grille: grill,grilla
grog: groc,groga
grogs: groc,groga
groller: grolleres,grollers
grotesco: grotesc,grotescos
gruesos: grua,grues
guap: guapes,guapa
guet: guetos,gueta
guitze: guitza,guitzes
gusto: gusta,gustos
habe: hab,haba
habit: habita,habida
habitante: habitants,habitantes
hablare: hablar,hablara
hagis: havers,hagi
hall: halle,halla,halls
halls: halle,halla
harto: harta,hartos
hast: hasta,hastos
haur: haura,haurs
haurie: hauria,hauries
havere: havers,havera
havie: havers,havia,havies
havies: havers,havia
heroique: heroica,heroiques
hipòcrit: hipòcrites,hipòcrita
hol: hola,hols
homenatja: homenatge,homenatges
honest: honesta,honests
honesto: honesta,honestos
honor: honora,honors
hope: hop,hopes
hor: hora,hors
horde: horda,hordes
hostatja: hostatge,hostatges
hostile: hostil,hostiles
hue: hua,hues
huesos: hua,hues
humid: humida,humids
humile: humil,humiles
ià: ian,iana
iard: iardes,iarda
ic: iques,ics
idèntic: idèntiques,idèntica
identific: identifiques,identifica
ideologie: ideologia,ideologies
idole: idol,idoles
ignorante: ignorants,ignorantes
ignorare: ignorar,ignorara
imà: iman,imans
imanes: iman,imans
ime: im,ima
immense: immensa,immenses
immerse: immers,immerses
immigrante: immigrants,immigrantes
impaciente: impacients,impacienta
impact: impactes,impacts
impactante: impactants,impactantes
impacto: impactes,impactos
impedimento: impediments,impedimentos
imperare: imperar,imperara
impertinente: impertinent,impertinentes
implique: implica,impliques
importe: import,importa
impose: imposa,imposes
impresionante: impresionant,impresionantes
imprevisto: imprevist,imprevistos
impulse: impulsa,impulses
inactiu: inactives,inactiva
incandescente: incandescent,incandescentes
incentive: incentius,incentives
incerte: incert,incerta
incidente: incidents,incidentes
incoherente: incoherent,incoherentes
incomode: incomoda,incomodes
incòmode: incòmoda,incòmodes
incompetente: incompetents,incompetentes
incomplete: incomplet,incompleta
incompleto: incomplet,incompletos
inconsciente: inconscients,inconscientes
inconsistente: inconsistents,inconsistentes
inconveniente: inconvenients,inconvenientes
incorrecto: incorrecta,incorrectos
incremento: incrementa,incrementos
inculto: incults,incultos
indicare: indicar,indicara
indiferente: indiferent,indiferenta
indiqué: indiquen,indiquens
indirecto: indirecta,indirectos
indiscrete: indiscret,indiscreta
indulto: indult,indultos
ineptos: inepte,inepta
inerte: inert,inerta
inexistente: inexistent,inexistentes
infante: infant,infanta
inferiore: inferior,inferiora
infinite: infinits,infinita
infinito: infinits,infinitos
ingente: ingent,ingentes
inherente: inherents,inherentes
iniciative: iniciativa,iniciatives
inicie: inicia,inicies
injusto: injusta,injustos
innato: innat,innatos
inocente: inocent,inocentes
inquietante: inquietant,inquietantes
ins: ine,ina
inscrito: inscrit,inscritos
insect: insecte,insectes,insects
insecto: insecte,insectes,insectos
insectos: insecte,insectes
insects: insecte,insectes
insensato: insensat,insensatos
instante: instants,instantes
instrumento: instrument,instrumentos
insuficiente: insuficient,insuficientes
insulte: insults,insulta
insulto: insults,insultos
intacto: intactes,intactos
inte: int,inta
integrante: integrants,integrantes
intendente: intendent,intendenta
intense: intensa,intenses
intensiu: intensives,intensius
intent: intente,intenta,intents
intentos: intente,intenta
intents: intente,intenta
interactive: interactiva,interactives
intern: internes,interns
interpose: interposa,interposes
interpret: interpretes,interprets
intèrprete: intèrpret,intèrpretes
interrogante: interrogant,interrogantes
intolerante: intolerant,intolerantes
intransigente: intransigent,intransigentes
inutile: inutil,inutiles
invasor: invasores,invasora
inverse: invers,inverses
inverso: invers,inversos
ire: ir,ira
irlandés: irlandès,irlandesa
ite: it,ita
jac: jaques,jaca
jag: jaques,jaga
jal: jales,jala
jaquet: jaquetes,jaqueta
jeràrquic: jeràrquiques,jeràrquica
joanne: joanna,joannes
jordà: jordan,jordana
jornade: jornada,jornades
jugar: jugada,jugat
jugara: jugada,jugat
jugare: jugada,jugat,jugara
jugars: jugada,jugat
jugo: jugada,jugat
jugos: jugada,jugat,jugo
junte: junt,junta
junto: junt,juntos
justifique: justifica,justifiques
justo: justes,justos
juventut: juventud,juventudes
juventuts: juventud,juventudes
kàs: kas,kasos
kasa: kas,kasos
kases: kas,kasos
ké: ken,kens
koste: kost,kosta
kurd: kurdes,kurda
lacrimògen: lacrimogen,lacrimògens
laique: laics,laiques
lamento: lamenta,lamentos
lande: land,landes
laque: laca,laques
larà: laran,larana
larg: largue,largues,larga
larga: largue,largues
largs: largue,largues
late: lades,lata
lave: lava,laves
legislative: legislatiu,legislatives
legitim: legitima,legitims
lent: lentes,lents
lento: lentes,lentos
lés: lès,leses
liberale: liberals,liberales
lic: liques,lics
lid: lides,lids
lidere: lider,lidera
lie: lia,lies
lié: lien,liens
liebe: lieb,liebes
lienes: lien,liens
ligue: liques,ligues
limite: limit,limita
linde: linda,lindes
líquit: líquids,líquida
lire: lir,lires
list: listes,lists
listo: listes,listos
lite: lides,lita
llaço: llaç,llaços
llag: llacs,llaga
llagost: llagostes,llagosta
llags: llacs,llaga
llarg: llargues,llargs
lleixe: lleixa,lleixes
lleu: lleves,lleus
lleuger: lleugeres,lleugers
llevare: llevar,llevara
llog: lloc,lloga
llogue: lloc,llogues
lluit: lluites,lluides
llumet: llumetes,llumeta
locate: locats,locata
locomotor: locomotores,locomotora
lote: lots,lota
lous: love,loves
lú: lune,luna
lubricante: lubricant,lubricantes
magnate: magnat,magnates
magnífic: magnífiques,magnífics
magnifique: magnific,magnifiques
mainader: mainaderes,mainadera
majordome: majordom,majordoma
majúscul: majúscules,majúscula
male: mal,mala
malmés: malmès,malmeses
maltés: maltès,maltesa
mame: mam,mames
manare: manar,manara
mandó: mandon,mandona
màneg: mànecs,mànegues
manejo: maneja,manejos
maner: manera,maners
maneresos: manera,maneres
manifestante: manifestant,manifestantes
manifeste: manifest,manifesta
manifesto: manifest,manifestos
mant: manta,mants
manuscrite: manuscrits,manuscrita
manuscrito: manuscrits,manuscritos
map: mapes,mapa
maquet: maquetes,maqueta
maquíssim: maquíssimes,maquíssima
maravell: maravelles,maravella
marejo: mareig,marejos
marià: marian,marianes
marisco: marisc,mariscos
marque: marcs,marques
marqués: marquès,marquesa
marxare: marxar,marxara
mascaret: mascaretes,mascareta
masse: massa,masses
mastec: mastegues,mastega
matare: matar,matara
mateixo: mateix,mateixos
materiale: materials,materiales
maternale: maternal,maternales
maxime: maxim,maxima
medievale: medievals,medievala
meine: mein,meina
mejore: mejor,mejora
mend: mendes,menda
menisco: meniscs,meniscos
mento: menta,mentos
meque: mec,meques
meravellós: meravellòs,meravelloses
mersos: mera,mers
metàfor: metàfores,metàfora
mic: miques,mica
mid: mides,mids
milersa: miler,milers
militante: militant,militantes
mille: mills,milla
millorada: milloro,millorat
millorades: milloro,millorat
millorats: milloro,millorat
mime: mim,mima
minore: minor,minora
minúscul: minúscules,minúsculs
minute: minuts,minutes
minuto: minuts,minutos
miope: miop,miopes
mirau: miraves,mirava
missils: missile,missiles
mitjo: mitges,mitjos
mito: mides,mitos
mixo: mix,mixos
mixt: mixta,mixts
mixto: mixta,mixtos
mobile: mobil,mobila
modele: models,modela
modest: modestes,modesta
modesto: modestes,modestos
mog: moca,moga
moixo: moix,moixos
molest: molestos,molests
moleste: molestos,molestes
molte: molt,moltes
molusco: moluscs,moluscos
momie: momia,momies
monda: monde,mondes
monete: monet,moneta
monumento: monuments,monumentos
mor: mora,mors
morale: morals,morales
moré: morè,morenes
moribunde: moribund,moribundes
morire: morir,morira
morte: mort,morta
mosque: mosca,mosques
mosquito: mosquits,mosquitos
mossegue: mossega,mossegues
motivador: motivadores,motivadora
motor: motores,motors
move: mous,moves
movie: movia,movies
mud: mudes,muds
muerte: muertos,muerta
mulato: mulata,mulatos
mult: multes,multa
multiplique: multiplica,multipliques
multo: multes,multos
mundiale: mundials,mundiales
munte: munt,munta
musicale: musicals,musicales
musique: music,musiques
mutante: mutant,mutantes
mute: mudes,muta
nande: nanda,nandes
narrative: narrativa,narratives
native: natiu,natives
naturale: naturals,naturales
nave: nava,naves
navegante: navegant,navegantes
navegue: navega,navegues
necessitate: necessitada,necessitates
nefasto: nefast,nefastos
negador: negadores,negadora
negative: negatius,negatives
negrete: negret,negreta
negue: nega,negues
neixe: neix,neixes
nelle: nell,nella
neste: nest,nesta
neto: nets,netos
nie: nia,nies
nig: nica,niga
nique: nica,niques
nó: non,nona
nocturn: nocturnes,nocturna
noie: noi,noies
nomenare: nomenar,nomenara
normative: normativa,normatives
norueg: noruec,noruegues
noruegs: noruec,noruegues
nové: novè,novena
nug: nuca,nuga
obe: ob,obes
obediente: obedients,obedientes
objective: objectiva,objectives
oblic: obligues,oblics
oblig: obligues,obliga
obririe: obriria,obriries
obscé: obscè,obscena
obscure: obscur,obscura
obsessive: obsessius,obsessives
obsolete: obsolets,obsoleta
obtingue: obtinga,obtingues
occidentale: occidental,occidentala
occidente: occident,occidenta
oculte: ocults,oculta
ocupante: ocupants,ocupantes
ode: oda,odes
ofec: ofegues,ofega
oferie: oferia,oferies
oïde: oïda,oïdes
oliu: olives,oliva
olore: olors,olora
ome: oms,oma
omnisciente: omniscient,omniscientes
omplene: omplen,omplena
onte: ont,onta
operate: operat,operates
operative: operatius,operatives
operato: operat,operatos
ops: ope,opa
optare: optar,optara
oque: oca,oques
orale: oral,orales
orb: orbe,orba,orbs
òrbit: òrbites,òrbita
orbs: orbe,orba
ordenadore: ordenador,ordenadora
ore: or,ora
org: orgues,orga
orgà: organ,organs
organitze: organitza,organitzes
orientale: orientals,orientales
oriente: orient,orientes
origen: orígens,orígenes
originale: originals,originales
orque: orc,orques
ortodoxo: ortodox,ortodoxos
ot: ota,ots
pacto: pacte,pactes,pactos
pactos: pacte,pactes
pag: paca,pagues,pags
pags: paca,pagues
pague: paca,pagues
paie: pais,paies
pal: pala,pals
palés: palès,palesa
palet: paletes,palets
paleto: paletes,paletos
palissade: palissada,palissades
pande: panda,pandes
panteixo: panteixa,panteixos
paperer: papereres,paperera
paps: pape,papa
paque: paca,paques
paquete: paquets,paquetes
paraís: paraiso,paraisos
parar: par,para
parcele: parcel,parcela
paré: paren,parens
parede: pared,paredes
parent: parenta,parents
parlada: parlar,parlat
parlades: parlar,parlat
parlamento: parlaments,parlamentos
parlante: parlant,parlantes
parlare: parlar,parlara
parlata: parlar,parlat
parlats: parlar,parlat
parlau: parlaves,parlava
parlere: parler,parlera
paro: par,para
parque: parcs,parques
parses: par,pars
parteixes: parteixen,parteix
particip: participo,participa,particips
participada: participo,participat
participades: participo,participat
participante: participant,participantes
participats: participo,participat
partícipe: partícip,partícipes
participe: participo,participa
participes: participo,participa
particips: participo,participa
partite: partides,partita
parto: part,partos
pasaporte: pasaport,pasaportes
pasare: pasar,pasara
passau: passaves,passava
passeig: passeges,passeja
passejo: passeges,passejos
passerelle: passerell,passerella
passive: passiu,passives
past: pastes,pasts
pastore: pastors,pastora
pateixe: pateix,pateixes
patente: patents,patenta
patja: patge,patges
pato: pat,patos
patró: patrò,patrons
pave: pau,paves
pavimento: paviment,pavimentos
pec: pegues,peca
pedante: pedant,pedantes
pedrer: pedreres,pedrera
peg: pegues,pega
peixater: peixateres,peixatera
penale: penal,penales
penetrante: penetrant,penetrantes
pensada: pensar,pensat
pensades: pensar,pensat
pensats: pensar,pensat
pensave: pensava,pensaves
peque: pegues,peques
perde: perda,perdes
perdere: perder,perdera
perdie: perdia,perdies
perdó: perdone,perdones
perdons: perdone,perdones
perfil: perfiles,perfila
perfume: perfum,perfuma
periods: periode,periodes
perito: perits,peritos
perjudique: perjudica,perjudiques
permanente: permanents,permanentes
permete: permets,permeta
permite: permit,permita
perplexe: perplexa,perplexes
persistente: persistents,persistentes
persuasive: persuasiva,persuasives
pertanye: pertanys,pertanya
pertinente: pertinents,pertinentes
perverse: pervers,perverses
perverso: pervers,perversos
perxe: perxa,perxes
pet: peta,pets
petate: petada,petates
petisos: peti,petis
petitíssim: petitíssimes,petitíssima
peto: peta,petos
petó: petò,petons
pí: pin,pina
pic: piques,pics
pijo: pija,pijos
pill: pilles,pills
pillare: pillar,pillara
pime: pim,pimes
pint: pintes,pints
piquete: piquets,piqueta
pirate: pirada,pirates
pix: pixes,pixa
plà: plan,plana
plac: plagues,placa
plaça: place,places
plaço: plaç,plaços
plag: plagues,plaga
planeig: planeges,planeja
plante: plant,planta
plaque: plagues,plaques
pleg: plec,plega
plegue: plec,plegues
ples: plan,plana
plore: plors,plora
pó: pon,pons
podens: puc,poden
podersos: puc,poders
podie: puc,podia,podies
podies: puc,podia
podrie: podria,podries
poem: poemes,poema
poesie: poesia,poesies
poet: poetes,poeta
poètique: poètica,poètiques
poguda: puc,pogut
pogudes: puc,pogut
poguts: puc,pogut
pole: pol,pola
polite: polit,polita
polític: polítiques,política
politique: politic,politiques
poll: polles,polls
polonés: polonès,polonesos
pome: pom,pomes
poné: ponen,ponens
pones: pon,pons
pore: por,pora
portau: portaves,portava
porto: ports,porta
portugués: portuguès,portuguesos
possare: possar,possara
posse: possa,posses
postale: postal,postales
poste: post,posta
postmodern: postmoderna,postmoderns
posto: post,postos
pòstum: pòstumes,pòstuma
potente: potents,potenta
practic: practiques,practica
pràctique: pràctics,pràctiques
precedente: precedents,precedentes
preferente: preferent,preferentes
preferire: preferir,preferira
pregó: pregon,pregona
pregunts: pregunte,pregunta
preme: prem,prema
premie: premia,premies
prenie: prenia,prenies
preocupante: preocupant,preocupantes
prepotente: prepotent,prepotentes
prés: près,presos
presencie: presencia,presencies
presentadore: presentador,presentadora
presente: presents,presentes
presidente: presidents,presidenta
presoner: presoneres,presonera
presse: pressa,presses
pressuposte: pressupostos,pressuposta
pretés: pretès,pretesa
preventive: preventiva,preventives
previst: previstos,prevists
previste: previstos,prevista
primate: primats,primates
primaver: primaveres,primavera
prime: prims,prima
primitive: primitiva,primitives
principale: principals,principales
problem: problema,problems
procedente: procedent,procedentes
productive: productiva,productives
produire: produir,produira
profe: prof,profa
professor: professora,professors
profund: profundes,profunds
progrés: progrès,progressos
progresse: progressa,progresses
progressive: progressiva,progressives
promete: promets,prometa
prometie: prometia,prometies
prominente: prominents,prominentes
pronuncie: pronuncia,pronuncies
propagande: propaganda,propagandes
prosper: prospera,prospers
protestante: protestant,protestantes
prove: prou,proves
provoque: provoca,provoques
prudente: prudent,prudenta
psicològic: psicològiques,psicològics
publicare: publicar,publicara
publique: public,publiques
pued: puede,puedes,pueda
pueda: puede,puedes
pug: pugues,puga
puguis: puc,pugui
puig: puges,puja
punte: punt,puntes
punto: punt,puntos
punxe: punxa,punxes
pure: purs,pures
qualifique: qualifica,qualifiques
qualssevols: qualsevol,qualssevol
quante: quant,quantes
quanto: quant,quantos
quart: quartes,quarta
quarto: quartes,quartos
quedada: quedara,quedat
quedades: quedara,quedat
quedar: quedara,queda
quedats: quedara,quedat
quedau: quedaves,quedava
quedos: quedara,quedo
queè: queen,queens
quei: queies,queia
queix: queixes,queixa
queixare: queixar,queixara
queme: quem,quema
quets: quete,queta
quie: qui,quies
quieto: quieta,quietos
quinto: quinta,quintos
quiosco: quiosc,quioscos
quite: quit,quita
rà: ran,rana
radicale: radicals,radicales
radioactive: radioactiu,radioactives
rafe: raf,rafa
rajo: raigs,rajos
rajol: rajoles,rajola
rame: ram,rama
ranxer: ranxeres,ranxera
rape: rap,rapa
ràpid: ràpides,ràpids
rare: rar,rares
ré: ren,rens
reaccionàrie: reaccionària,reaccionàries
realitza: realitzats,realitzat
realitzar: realitzats,realitzat
realitzo: realitzats,realitzat
rebaix: rebaixes,rebaixa
recerque: recerca,recerques
recollie: recollia,recollies
record: recorde,recordes,records
recorda: recorde,recordes
records: recorde,recordes
recto: recta,rectos
rectore: rector,rectora
recurrente: recurrent,recurrentes
recurso: recurs,recursos
rede: red,redes
refie: refia,refies
reforço: reforç,reforços
reform: reformes,reforms
refrede: refreda,refredes
refresco: refrescs,refrescos
refresque: refresca,refresques
refugie: refugia,refugies
reg: reca,rega
regente: regent,regenta
regionale: regional,regionala
reglamento: reglament,reglamentos
regs: reca,rega
regue: reca,regues
regusto: regust,regustos
rel: rela,rels
relat: relata,relats
relative: relatius,relatives
relato: relata,relatos
remolque: remolc,remolques
remote: remots,remota
remoto: remots,remotos
renovare: renovar,renovara
renove: renous,renoves
repasse: repassa,repasses
repe: reps,repa
repetire: repetir,repetires
reporte: report,reporta
représ: reprès,represes
represent: representes,represents
representante: representants,representantes
representate: representats,representates
representative: representativa,representatives
repugnante: repugnants,repugnantes
repulse: repulsa,repulses
repulsive: repulsius,repulsives
rescat: rescata,rescats
respectare: respectar,respectara
respective: respectius,respectives
respiratorie: respiratoria,respiratories
respongue: responga,respongues
respós: respòs,resposes
resposte: respost,resposta
ressó: ressò,ressona
restante: restants,restantes
restrictive: restrictiva,restrictives
result: resultes,results
resultante: resultant,resultantes
resultar: resultes,resulta,resultat
resultat: resultes,resulta
resultata: resultes,resulta,resultat
resultats: resultes,resulta,resultat
resulto: resultes,resulta
resume: resum,resumes
reta: reto,retos
retarde: retard,retardes
retes: reto,retos
reticente: reticent,reticentes
retire: retir,retira
retòric: retòriques,retòrica
retorn: retorna,retorns
retrate: retrat,retrata
retrete: retret,retreta
retrospective: retrospectiva,retrospectives
rets: reto,retos
reverse: revers,reverses
reverso: revers,reversos
revise: revisa,revises
revolto: revoltes,revoltos
rib: ribes,ribs
rim: rimes,rims
rinoceronte: rinoceronts,rinocerontes
rit: rita,rides
rito: rita,ritos
robusto: robust,robustos
rode: rod,rodes
rodete: rodet,rodeta
roig: roges,roigs
rojo: roges,rojos
role: rols,rola
rome: rom,roma
rond: rondes,ronda
roque: rocs,roques
rug: rucs,ruga
rumore: rumor,rumores
rurale: rurals,rurales
rús: ruse,ruses
rusa: ruse,ruses
rusos: ruse,ruses
russos: ruse,ruses
rústique: rústic,rústiques
sab: sabes,sabs
saber: sabera,sé
sabie: sabia,sabies
sacrifique: sacrifica,sacrifiques
saig: sage,sages
saigs: sage,sages
sale: sals,sales
salt: saltes,salts
salute: saludes,saluta
salvare: salvar,salvara
saqueig: saquejos,saqueja
seconde: second,secondes
secrete: secret,secretes
secreto: secret,secretos
sede: seda,sedes
segmento: segments,segmentos
segueixe: segueix,segueixes
sei: seies,seia
sele: sel,sela
select: selecte,selecta,selects
selective: selectiva,selectives
selecto: selecte,selecta,selectos
selectos: selecte,selecta
selects: selecte,selecta
sell: sella,sells
semblada: semblo,semblat
semblades: semblo,semblat
semblats: semblo,semblat
semblave: semblava,semblaves
seme: sem,sema
sende: senda,sendes
senser: senseres,sensera
sente: sent,senta
sentí: sentin,sentina
sentir: sentida,sentit
sentira: sentida,sentit
sentire: sentida,sentit,sentira
sentires: sentida,sentit
sentirs: sentida,sentit
senyore: senyor,senyora
separate: separada,separata
seque: seca,seques
sequer: sequera,sequers
series: sers,seria
serrador: serradores,serradora
serve: serva,serves
servent: serventes,servents
seté: setè,setena
seule: seul,seules
seve: seu,seves
severe: severs,severa
sexo: sex,sexos
sient: sienta,sients
signific: signifiques,significa
siguia: sers,sigui
siguis: sers,sigui
simpatitze: simpatitza,simpatitzes
sincere: sincers,sinceres
sisé: sisè,sisena
sistem: sistemes,sistems
sit: sid,sida
sita: sid,sida
site: sid,sida,sita
sites: sid,sida
sits: sid,sida
situate: situades,situata
sobrevive: sobrevius,sobrevives
sociologie: sociologia,sociologies
sog: soca,soga
sole: sol,sola
soma: sers,som
some: sers,som,soma
somes: sers,som
somnie: somnia,somnies
soms: sers,som
soneto: sonets,sonetos
sonore: sonor,sonora
sóns: sers,són
sorte: sorts,sorta
sortire: sortir,sortira
sospitós: sospitòs,sospitosa
sote: sots,sota
sotmés: sotmès,sotmesos
stare: stars,stara
ste: st,sta
stripe: strip,stripes
súbdito: súbdit,súbditos
sube: subs,suba
sublime: sublim,sublima
sucés: sucesso,sucessos
sucesos: sucesso,sucessos
sue: sua,sues
suene: suen,suena
suits: suite,suites
sum: suma,sums
super: supera,supers
superbe: superb,superba
superiore: superiors,superiora
suplente: suplent,suplenta
suporte: suports,suporta
suque: suc,suques
sure: sur,sura
suso: su,sus,susos
susos: su,sus
tabe: tab,taba
tailandés: tailandès,tailandesa
talle: talls,talles
tame: tam,tama
tanc: tanques,tanca
tangente: tangent,tangentes
tante: tant,tanta
tape: tap,tapes
tarda: tarde,tardes
tardare: tardar,tardara
tards: tarde,tardes
tarif: tarifes,tarifa
tarjet: tarjetes,tarjeta
tats: tate,tata
teatrale: teatral,teatrales
tècnique: tècnic,tècniques
teie: teia,teies
telegram: telegrames,telegrama
teme: tems,tema
tenens: tinc,tenen
tenie: tinc,tenia,tenies
tenies: tinc,tenia
tenims: tinc,tenim
tentative: tentativa,tentatives
tèrbol: tèrboles,tèrbola
tere: ter,tera
terminale: terminal,terminales
terminologie: terminologia,terminologies
terrós: terròs,terrossos
testamento: testament,testamentos
testo: tests,testos
teve: teu,teves
text: textos,texts
texte: textos,texta
tí: tin,tina
tie: tia,ties
tiesos: tia,ties
tig: tics,tiga
tigue: tics,tigues
timbale: timbals,timbales
tímit: tímids,tímides
tímits: tímids,tímides
tinguda: tinc,tingut
tingudes: tinc,tingut
tinguts: tinc,tingut
tipe: tips,tipa
tique: tics,tiques
tire: tirs,tires
tocave: tocava,tocaves
tode: toda,todes
tog: tocs,toga
tolerante: tolerant,toleranta
tolle: toll,tolles
tope: top,topa
tornada: tornar,tornat
tornades: tornar,tornat
tornats: tornar,tornat
torrente: torrent,torrentes
torso: tors,torsos
tosco: tosc,toscos
tote: tot,tota
toute: tout,toutes
trada: trade,trades
trads: trade,trades
traduire: traduir,traduira
trafique: trafica,trafiques
trague: traga,tragues
trame: trams,trama
tranquile: tranquil,tranquila
transform: transformes,transforms
transite: transit,transita
transmés: transmès,transmesa
transparente: transparent,transparenta
transporte: transports,transporta
trast: trastos,trasts
traste: trastos,trasta
trat: trade,trades
trata: trade,trades
trates: trade,trades
tratos: trade,trades
trats: trade,trades
trau: traves,traus
treballos: treballar,treballo
tretzé: tretzè,tretzena
tríade: tríada,tríades
tribute: tribut,tributa
tributo: tribut,tributos
trigare: trigar,trigara
trobau: trobaves,trobava
trossos: tro,tros
trou: troves,trous
tube: tubs,tuba
tue: tua,tues
ule: ul,ula
ulle: ulls,ulla
ultratja: ultratge,ultratges
unànims: unànime,unànima
unic: unique,uniques,unica
unica: unique,uniques
unics: unique,uniques
unite: unida,unita
universale: universal,universala
universe: universos,universes
urgente: urgents,urgentes
urn: urnes,urna
usave: usava,usaves
ute: ut,utes
utile: utils,utila
vacante: vacant,vacantes
vag: vagues,vaga
vaigues: vaig,vaiga
valdrie: valdria,valdries
valent: valentes,valenta
valgue: valga,valgues
validate: validats,validates
valie: valia,valies
valle: valls,valla
vals: valdre,val
vampir: vampira,vampirs
vaque: vagues,vaques
variante: variant,varianta
vàs: vas,vasos
vasa: vas,vasos
vases: vas,vasos
vassos: vas,vasos
vaste: vastos,vasta
vé: vene,vena
vegade: vegada,vegades
veie: vei,veies
veigues: veges,veiga
veïne: veins,veïnes
vele: vel,vela
venie: venia,venies
vens: vene,vena
vento: venta,ventos
verbale: verbal,verbales
verbe: verb,verba
vere: ver,veres
veré: veren,verena
verifique: verifica,verifiques
vermelle: vermells,vermelles
vertígen: vertigen,vertígens
ves: venir,ve
vestie: vestia,vesties
vestiment: vestimentes,vestimenta
vete: vet,veta
veto: vet,vetos
vibrante: vibrant,vibrantes
victim: victima,victims
víctim: víctimes,víctima
vidrio: vidriosos,vidrios
vigente: vigents,vigentes
vinca: venir,vinc
viol: violes,viols
violent: violentes,violents
violento: violentes,violentos
visitante: visitant,visitantes
visto: vistes,vistos
visuale: visual,visuales
visualitze: visualitza,visualitzes
vivie: vivia,vivies
vó: von,vona
voca: vogue,vogues
vocale: vocal,vocales
voga: vogue,vogues
vole: vols,voles
volens: vull,volen
voleva: vull,voleu
volguda: vull,volgut
volgudes: vull,volgut
volguts: vull,volgut
volie: vull,volia,volies
volies: vull,volia
volt: volta,volts
volume: volums,volumes
vorer: voreres,vorera
vors: vore,vores
votante: votants,votantes
vulgare: vulgar,vulgares
vulgue: vulga,vulgues
wale: wal,wala
wé: wen,wens
xafardejo: xafardeig,xafardejos
xamà: xaman,xamans
xicot: xicotes,xicota
xicotete: xicotet,xicoteta
xinxe: xinxa,xinxes
xiquet: xiquetes,xiquets
xiuxiueig: xiuxiuejos,xiuxiueja
xocolat: xocolates,xocolada
xulet: xuletes,xuleta
xup: xupes,xupa
xute: xut,xuta
zé: zen,zena
